Pop.Code	Super.Pop.Code
CHB	EAS
CHD	EAS
JPT	EAS
CHS	EAS
CDX	EAS
KHV	EAS
CEU	EUR
TSI	EUR
FIN	EUR
GBR	EUR
IBS	EUR
YRI	AFR
LWK	AFR
GWD	AFR
MSL	AFR
ESN	AFR
ASW	AFR
ACB	AFR
MXL	AMR
PUR	AMR
CLM	AMR
PEL	AMR
GIH	SAS
PJL	SAS
BEB	SAS
STU	SAS
ITU	SAS